222222211111111111111
22222221w000q1t0м0e31
2222222111101100q0001
22222221q000000q00w01
111111111100q11111111
1q0000000000033000e31
111м0w0000000000e0031
1.30011001111100000а1
1и00q1w00м00ш1и000031
1000q1000000010м00w31
1и0001e0e00qq11111111
100w0133300w312222222
1111111111111122222222