222222222222211111111
22222222222221w0000q1
111111111111111100111
1e0e0331q00qq1q000мq1
10030w310000q1t000e31
1и3.30м1м000010000331
100300q1e000а11011111
1и000001000001001w0ш1
100000q11100110000001
1qq00001w000000011111
1w0000000000000000w31
133qw3310000w000w0331
1111111111111111111111