222222111122221111111
22111110ш111111q00001
221w000001иw0q1q00e31
2210000001000q1000331
221w010001000м1001111
22111100q100000000w01
111q010w01w000e000031
1м00000111000000а1111
100000000000000001222
10101111000000.111222
1q1e001t00w00..122222
1q1330100q11111122222
1111111111122222222222