222222111111111111111
1111111.w0000qq0003.1
1e0000330000000000031
1000001.000111q001..1
10000q1.0e0111q001011
10000ш1и0000w000010ш1
1м00001000000000м1q01
1101111w0000000011111
10000q1000000w0000w01
1000q1000111011000001
1и0q1e001e0q0010000а1
100q100010000q1w00001
1111111111111111111111