111111111111111111111
1.301q0w01t0000w01w01
130q10000100000000001
1q001000010w000001001
1000м0000101111111q01
10000000qq000w00м10q1
10000000011100q001001
1и00e000ш1000000q0031
1000000331q1w000q13.1
111110111111111111111
2221и01000q1222222222
222100000qq1222222222
2221111111112222222222