111111111111111111111
1e00w0100ш1q00w000t01
1300001w001w010000001
1.3000100011110000001
1111101q111м000011101
1q0000000w0000001e001
1и000000000000w0130q1
1330qq000011111111111
111111110000000000w01
2222222100000w3330001
22222221q00а1111111q1
22222221w0001мw0q0001
2222222111111111111111