111111111111111111111
1e000001t0001t001t001
100000010000100010001
11111011w000100q100q1
1м0000010110101q101q1
100000а1w0101q101q101
100000011110111011101
10e000000w00000000001
100000000000м00000w01
1q000001101111100q111
1300ш10130000q11010q1
1..301q1.30w0111000q1
1111111111111111111111