222221111112222222222
22221w00w0а1222222222
111110000001111111222
1e33100e0001e00w03122
10031000000100q00w312
1и001q0000q100000w311
100011011111011111111
1w0000000w0q000000w01
1111м0000000000000e01
1w0100001101101м00001
11000000100q10100t031
1q00w00q1w001q1w003.1
1111111111111111111111