111111111111111111111
1e0ш1q001и0t0а1e000ш1
100010e01000001000q01
100010001иw00010000ш1
100010w010w000000q001
1q0010111111110м11111
100q100м1q0w0101q03.1
1101100011011w0100031
13000000w000000000w01
1.w00w000000000111111
11111110111111q0000.1
22222210w01w0000w03.1
2222221111111111111111
